Alleles,ChinRhe,IndiRhe,IndoCyn,MaurCyn,Total,Leader only,Upstream only,Both primers sets,Seq
IGHD1-1*01,12,15,6,12,45,F,F,T,GGTATAGCTGGAACTAT
IGHD1-2*01,12,15,6,12,45,F,F,T,GGTATAACTGGAACGAC
IGHD1-3*01,12,15,6,12,45,F,F,T,GGTATAGCTGGAACGAC
IGHD1-4*01,12,15,6,12,45,F,F,T,GATATAGCTGGAACAAC
IGHD1-5*01,12,15,6,12,45,F,F,T,GGTATAACTGGAACTAC
IGHD1-6*01,12,15,6,12,45,F,F,T,GGTATAACTGGAATGAC
IGHD1-7*01,12,15,6,12,45,F,F,T,GGAACACCTGGAACGAC
IGHD1-8*01,12,15,6,12,45,F,F,T,GGTATAGTGGGAGCTACAAC
IGHD2-10*01,12,15,5,6,38,F,F,T,AGAATATTGTAGTAGTACTTACTGCTCCTCC
IGHD2-10*01_S295,0,1,1,10,12,F,F,T,AGAATATTGTAGTAGTACTTACTGCTACGCC
IGHD2-10*01_S8741,4,1,3,8,16,F,F,T,AGCATATTGTAGTGGTACTTACTGCTCCTCC
IGHD2-11*01,12,15,6,12,45,F,F,T,AGAATACTGTACTGGTAGTGGTTGCTACGCC
IGHD2-11*01_S1259,6,4,5,8,23,F,F,T,AGAATACTGTACTGGTAGTGGTTGCTATGCC
IGHD2-12*01,12,15,6,12,45,F,F,T,AGAATATTGTAGTGGTATTTACTGCTATGCC
IGHD2-13*01,12,15,6,12,45,F,F,T,AGCACACTGTAGTGATAGTGGCTGCTCCTCC
IGHD2-14*01,1,3,3,8,15,F,F,T,AGCATATTGTAGTCGTGGTGTCTGCTACGCC
IGHD2-14*02_S0040,3,2,4,12,21,F,F,T,AGCATATTGTAGTGGTACTTACTGCTACGCC
IGHD2-14*02_S0100,12,15,6,10,43,F,F,T,AGGATATTGTAGTGGTGGTGTCTGCTACACC
IGHD2-14*02_S1717,2,2,1,4,9,F,F,T,AGGATATTGTAGTGGTGGTGTCTGCTATGCC
IGHD2-9*01,12,15,6,12,45,F,F,T,AGGATATTGTACTAGTACTACTTGCTATGCC
IGHD3-15*01,12,15,6,12,45,F,F,T,GTATTACGAGGATGATTACGGTTACTATTACACCCACAGCGT
IGHD3-16*01,12,15,1,12,40,F,F,T,GTATTACTATAGTGGTAGTTATTACTACCACAGTGT
IGHD3-17*01,12,15,6,12,45,F,F,T,GTACTGGGGTGATTATTATGAC
IGHD3-18*01,12,15,6,12,45,F,F,T,GTATTACTATGGTAGTGGTTATTACACCCACAGCGT
IGHD3-19*02_S4720,12,15,6,12,45,F,F,T,GTACTGGAGTGATTATTATGAC
IGHD3-20*01,12,15,6,12,45,F,F,T,GTATTACGATTACGATATTAGTAGTCGATATTAAACC
IGHD3-41*01,7,9,2,5,23,F,F,T,GTATTACAATATTTGGACTGGTTATTATACC
IGHD3-41*01_S1308,2,0,2,0,4,F,F,T,GTATTACAATATTTGGACTGGTTATTACACC
IGHD3-41*01_S1524,3,0,4,0,7,F,F,T,GTATTACAATATTTGGAGTGGTTATTACACC
IGHD3-41*01_S4389,2,0,0,0,2,F,F,T,GTATTACAATTTTTGGACTGGTTATTATACC
IGHD3-41*01_S8240,7,13,3,12,35,F,F,T,GTATTACAATTTTTGGAGTGGTTATTACACC
IGHD4-21*01,7,11,4,10,32,F,F,T,TGACTACCATAACTA
IGHD4-23*01,12,15,6,12,45,F,F,T,TGAATACAGTAACTAC
IGHD4-24*01,12,15,6,12,45,F,F,T,TGACTACGGTAGCAACTAC
IGHD4-25*01,12,15,6,12,45,F,F,T,TGACTACGGTAACTAC
IGHD5-27*01,12,15,6,12,45,F,F,T,GTGGATACAGTGGGTACAGTTAC
IGHD5-28*01,12,15,6,11,44,F,F,T,GTGGATACAGCTACAGTTAC
IGHD5-28*01_S4021,0,0,0,5,5,F,F,T,GTGGATATAGCTACAGTTAC
IGHD5-29*01,2,3,0,1,6,F,F,T,GTGGATACAGCTACAGTTACCACAGTTTTGCCACC
IGHD5-31*01,12,15,6,12,45,F,F,T,GTGGATATAGCTACGGTTAC
IGHD5-32*01,10,12,6,11,39,F,F,T,GGGGATACAGTGGGTACAGTTAC
IGHD5-32*01_S0263,8,5,5,0,18,F,F,T,GGAGATACAGTGGGTACAGTTAC
IGHD5-32*01_S0995,11,14,4,12,41,F,F,T,GGGGATACAGCGGGTACAGTTAC
IGHD5-32*01_S2987,5,0,0,0,5,F,F,T,GGAGATACAGCGGGTACAGTTAC
IGHD6-33*01,12,15,6,12,45,F,F,T,GGGTATAGCAGCGGCTGGTAC
IGHD6-33*01_S4467,0,0,0,1,1,F,F,T,GGGTATAGCAGCAACTGGTAC
IGHD6-34*01,12,15,6,12,45,F,F,T,GGGTATAGCAGCTGGTCC
IGHD6-35*01,12,15,6,12,45,F,F,T,GGGTATAGCAGCAGATCC
IGHD6-36*01,12,15,6,12,45,F,F,T,GGGTATAGCGGCAGCTGGAAC
IGHD6-38*01,12,15,6,12,45,F,F,T,GGGTATAGCGGTGGCTGGTCC
IGHD6-38*01_S4618,3,3,2,7,15,F,F,T,GGGTATAGTGGTGGCTGGTCC
IGHD6-39*01,12,15,6,12,45,F,F,T,GGGTATAGCAGCAGCTAC
IGHD6-39*01_S0850,7,2,0,0,9,F,F,T,GGGTATAGCAGCTAC
IGHD7-40*01,12,15,6,12,45,F,F,T,CTAACTGGGGA
